NO  ./image/1.xpm


SO     ./image/2.xpm
WE              ./image/3.xpm
EA  ./image/4.xpm

F        0,55,55
C       155,155,155

            1111111111111111111111111111111111111
            1000000E00000000000000000000000000011
            1000000000000000000000000001111110001
            1000000000000000000000000001    10001
            1000000000000000000110101101    11111
            1000000000000000000100101101    10001
            1000000000000000000000000001    10001
            1111111111111111111111111111111111111

