NO  ./image/1.xpm


SO     ./image/2.xpm
WE              ./image/3.xpm
EA  ./image/4.xpm

F        0,55,55
C       155,155,155

            1111111111111111111111111111111111111
            1000000W00000000000000000001000000001
            1000000k00000000000000000001111110001
            1000000000000000000000000001    10001
            1111111111111111111111111111111111111

